07 12 04
XXXXXXX
X...G.X
X.....X
XG.G.GX
X..X.XX
X.JG..X
XXX.J.X
XXX.X.X
X.JJ..X
X.JM..X
X...XXX
XXXXXXX
