05 05 01
XXXXX
X..GX
X.J.X
XM..X
XXXXX
