07 07 03
XXXXXXX
XG..J.X
X.J..GX
XM...JX
X.....X
X....GX
XXXXXXX
