07 05 02
XXXXXXX
X..G..X
X.J...X
XM..JGX
XXXXXXX
